type octyl
height 32
width 32
map
....@....@@....@.@...@..@.......
........@...@..@.........@..@...
.@.......@..@....@.@@........@@@
..@.@..@@...........@...........
.@....@.........@@....@........@
.@....@.@..........@............
@..@.........@.....@..@.@..@....
...@.@..@.@@.@@.....@...........
..................@....@....@.@.
...........@...@...@.......@....
.....@@...@.........@@@..@......
.....@..@@.....@.@..@...........
......@.......@.....@.....@@@@.@
.@....@..@..@.....@.....@......@
..@.@..@...@..@..........@@.....
..@@...@...@@.........@@.....@.@
............@@.....@............
.@.@...@..@..............@@.@@..
.@@.....@..@.........@@@........
..........@....@...........@.@..
@@.....@...@.@.....@@.....@.@...
@.@.@@...@...@.............@....
..@.......@......@....@.........
.....@..............@...........
..@...@..@.......@.......@@.@@..
........@@@..........@.@......@.
@.......@.......@....@...@...@.@
.@@@......@@@.......@..@.@..@...
......@.@.........@..........@..
.@..........@@.....@.@.@.@....@.
.@......@..@.....@@.......@@....
@......@...@...@....@.....@@....
