type octyl
height 8
width 8
map
........
...@@...
........
@@@.....
.@@..@@.
.......@
..@.....
..@.....
